#############################
#                           #
#        INTO VOID          #
#                           #
#     w=up     s=down       #
#     a=left   d=right      #
#                           #
#############################
# @ #        #              #
#   #  ###  ##   #####      #
#      #        ## \        #
#############################