                      
 #####################
 #@          #       #
 #      #    #       #
 #      #    #       #
 #      #    #       #
 #      #    #       #
 #   E  #    #       #
 #      # #          #
 #      # #          #
 #      # #          #
 #      # #          #
 #                 \ #
 #####################