                                   
 ##################################
 #@      #                 #      #
 #  #    #     #########      #   #
 #  #    #  ####       ########   #
 #  #    #     #  ##   #          #
 #  #    ####  #  ##   # ##########
 #  ####       #  ##   #          #
 #  #   #########  ##  #######    #
 #                       #        #
 ####################### ##########
 #                     #          #
 #   ################  # #######  #
 #   #            #    # #     #  #
 #   # #####  # ###  ### #  #  #  #
 #     # \    #   #      #  #     #
 ##################################